11111111111111111111
10000000000000000001
10111111111111111001
10000000000000000001
10111111111111111001
10000000000000000001
10111111111111111001
10000000000000000001
10111111111111111001
10000000000000000001
10000000000000000001
10111111111111111001
10111111111111111001
10000000000000000001
1P00CCCCCCCCCCC000E1
11111111111111111111 