11111111111111111111
10C00000000000000C01
10000000000000000001
10000000000000000001
10000000000000000001
1000000C000C00000001
10000000000000000001
1000C000000000C00001
10000000000000000001
10000000000000000001
10000000000000000001
1000000C000C00000001
10000000000000000001
10C00000000000000C01
1P0000000000000000E1
11111111111111111111 