11111111111111111111
1P000000000000000001
10111011101110111101
1000C000000C00000001
10111011101110111101
10000000000000000001
10111011101110111101
1000C000000C00000001
10111011101110111101
10000000000000000001
10111011101110111101
1000C000000C00000001
10111011101110111101
10000000000000000001
100000000000000000E1
11111111111111111111 