1111111111111
1001000000001
100001111g001
1P0011E000001
1111111111111