1111111111
1000000001
1000000001
1000000001
1000000001
1P0C00DE01
1000000001
1000000001
1000000001
1111111111