1111111111
1000000001
10C0000001
1000000001
1000000001
1000000001
1000000001
1000000001
10000000E1
1111111111 