1111111111
1000000001
1000000001
1000000001
1000000001
1000000001
1000000001
1000000001
10P00000E1
1111111111 